1111111111111111
1000010000000C01
1111110000000001
1CCCCCCCCCCCCCC1
1000000000111111
1111100000000001
10011110000P0001
100E000000000001
1111111111111111
