1111111111111111
1000000000000001
1000000P00000001
100000000C000001
100000C000000001
1000000000000E01
1111111111111111
