1111111111111111
10C0100000000001
1111100000000001
1000P00000000001
1000000000C00001
1000000000000E01
1111111111111111
