1111111111111111
10CE00000C0C0P01
1111111111111111
