1111111111111111
10D0010000000001
1111110000000001
1000000000000001
10E000CC00111111
111110P0CCC00001
10011110D0C00001
1000000000000001
1111111111111111
