1111111111111111
10000000CE0C0P01
1000000000000001
1111111111111111
