111111111111111111111111111111111111111
100000000EPC000000000000000000000001111
111111111111111111111111111111111111111